10 10
-1 -1 -1 1 -1 -1 -1 -1 1 1
1 1 1 -1 -1 1 -1 1 1 -1
1 1 -1 -1 -1 -1 1 -1 1 -1
-1 -1 1 1 1 1 -1 1 -1 1
1 1 1 -1 1 1 1 -1 -1 -1 
-1 1 1 -1 1 -1 1 -1 -1 1
1 1 -1 -1 1 1 -1 1 -1 1
-1 -1 -1 1 1 -1 -1 1 1 -1
1 -1 1 1 -1 1 1 -1 1 1 -1
-1 -1 1 1 1 1 1 -1 1 -1